kc:/medicine/disease:symptoms	What is a symptom of XXX?
kc:/people/person:movies	In which movie you can see XXX?
kc:/music/artist:songs	Which of the songs was recorded by XXX?
kc:/music/artist:latest album	Which is the latest album from XXX?
kc:/music/artist:albums	Which is an album by XXX?
kc:/medicine/disease:causes	What causes XXX?
kc:/film/film:director	Who was the director of XXX?
kc:/book/written_work:author	Which of the following is the author of the book XXX?
kc:/business/business_operation:founder	Who is the founder of XXX?
kc:/organization/organization:headquarters	Where is the headquarter of XXX?
kc:/people/deceased_person:cause of death	What was the cause of death of XXX?
kc:/people/person:children	Which of the following is the children of XXX?
kc:/people/person:education	Which education institution did XXX attend?
kc:/people/person:parents	Which of the following is the parent of XXX?
kc:/people/person:place of birth	Where was XXX born in?
kc:/medicine/disease:nondrug treatments	What is a treatment for XXX?
kc:/people/person:current_partner	Who is the current spouse of XXX?
kc:/people/person:spouse	Who is/was the spouse of XXX?
kc:/visual_art/artwork:artist	Which was the artist of the artwork XXX?
kc:/medicine/drug:side effect	What is a side effect of XXX?
kc:/american_football/football_coach:current team	Which of the american football team is XXX the current head coach?
kc:/baseball/baseball_coach:team	Which of the baseball team is XXX coaching currently?
kc:/basketball/basketball_team:head coach	Which of the basketball team is XXX the head coach?
kc:/book/book:characters	Which of the following book characters appear in the book XXX?
kc:/book/book:genre	What is the genre of the book XXX?
kc:/business/business_operation:industry	Which of the following industry is/was XXX operating in?
kc:/cricket/cricket_coach:team	Which of the cricket team is XXX coaching currently?
kc:/education/educational_institution:football team	Which of the following is the sports team of XXX?
kc:/film/film:genre	What is the genre of the film XXX?
kc:/government/politician:current position	Which government position is XXX in?
kc:/ice_hockey/hockey_coach:team	Which of the ice hockey team is XXX coaching currently?
kc:/ice_hockey/hockey_team:captain	Who is/was the captain of the ice hockey team XXX?
kc:/wine/wine:country	Where is the wine XXX produced in?
kc:/people/person:profession	What is/was the profession of XXX?
kc:/people/person:nationality_id	What is the nationality of XXX?
kc:/medicine/medical_treatment:side effect	What is a side effect of XXX?
kc:/film/film:featured song	What is the feature song of XXX?
kc:/government/us_president:vice president	Who is/was the vice president of XXX?
kc:/government/politician:party	Which of the following politician party was XXX in?
kc:/business/business_operation:industry	Which industry is/was XXX operating in?
kc:/organization/organization:place founded	Where was XXX founded?
kc:/organization/organization:leadership	Who is/was part of the leadership team in XXX?
kc:/organization/organization:date founded	When was XXX founded?
kc:/organization/organization:headquarters	Where is/was the headquarter of XXX?
kc:/organization/organization:founder	Who was the founders of XXX?
