kc:/american_football/football_coach:current team	/american_football/football_coach/current_team_head_coached
kc:/american_football/football_coach:teams coached	/american_football/football_coach/coaching_history
kc:/american_football/football_team:conference	/american_football/football_team/conference
kc:/american_football/football_team:division	/american_football/football_team/division
kc:/american_football/football_team:head coach	/american_football/football_team/current_head_coach
kc:/american_football/football_team:stadium	/sports/sports_team/arena_stadium
kc:/amusement_parks/park:annual visits	/amusement_parks/park/annual_visits
kc:/amusement_parks/park:closed	/amusement_parks/park/closed
kc:/amusement_parks/park:opened	/amusement_parks/park/opened
kc:/amusement_parks/park:rides	/amusement_parks/park/rides
kc:/amusement_parks/ride:capacity	/amusement_parks/ride/capacity
kc:/amusement_parks/ride:closed	/amusement_parks/ride/closed
kc:/amusement_parks/ride:cost	/amusement_parks/ride/cost
kc:/amusement_parks/ride:designer	/amusement_parks/ride/designer
kc:/amusement_parks/ride:drop	/amusement_parks/ride/drop
kc:/amusement_parks/ride:duration	/amusement_parks/ride/duration
kc:/amusement_parks/ride:g-force	/amusement_parks/ride/max_g
kc:/amusement_parks/ride:height	/amusement_parks/ride/height
kc:/amusement_parks/ride:height restriction	/amusement_parks/ride/height_restriction
kc:/amusement_parks/ride:inversions	/amusement_parks/ride/inversions
kc:/amusement_parks/ride:manufacturer	/amusement_parks/ride/manufacturer
kc:/amusement_parks/ride:max speed	/amusement_parks/ride/max_speed
kc:/amusement_parks/ride:opened	/amusement_parks/ride/opened
kc:/amusement_parks/ride:park	/amusement_parks/ride/park
kc:/amusement_parks/ride:theme	/amusement_parks/ride/theme
kc:/amusement_parks/ride_designer:designed	/amusement_parks/ride_designer/rides
kc:/amusement_parks/roller_coaster:material	/amusement_parks/roller_coaster/material
kc:/amusement_parks/roller_coaster:propulsion	/amusement_parks/roller_coaster/propulsion
kc:/amusement_parks/roller_coaster:track length	/amusement_parks/roller_coaster/track_length
kc:/architecture/architect:designed	/architecture/architect/structures_designed
kc:/architecture/building:floor space	/architecture/building/floor_space_square_meters
kc:/architecture/building:floors	/architecture/building/floors
kc:/architecture/building:function	/architecture/building/building_function
kc:/architecture/building:occupant	/architecture/building/occupant
kc:/architecture/engineer:projects	/architecture/engineer/projects
kc:/architecture/lighthouse:automated	/architecture/lighthouse/automated
kc:/architecture/lighthouse:first lit	/architecture/lighthouse/year_first_lit
kc:/architecture/lighthouse:focal height	/architecture/lighthouse/focal_height_of_light
kc:/architecture/lighthouse:intensity	/architecture/lighthouse/intensity
kc:/architecture/lighthouse:material	/architecture/lighthouse/construction
kc:/architecture/lighthouse:out of service	/architecture/lighthouse/out_of_service_date
kc:/architecture/lighthouse:tower shape	/architecture/lighthouse/tower_shape
kc:/architecture/museum:address	/architecture/museum/address
kc:/architecture/museum:director	/architecture/museum/director
kc:/architecture/museum:established	/architecture/museum/established
kc:/architecture/skyscraper:height	/architecture/skyscraper/height_with_antenna_spire_meters
kc:/architecture/structure:address	/architecture/structure/address
kc:/architecture/structure:architect	/architecture/structure/architect
kc:/architecture/structure:architectural style	/architecture/structure/architectural_style
kc:/architecture/structure:architecture firm	/architecture/structure/architecture_firm
kc:/architecture/structure:closed	/architecture/structure/closed
kc:/architecture/structure:destroyed by	/architecture/structure/destroyed_by
kc:/architecture/structure:destruction date	/architecture/structure/destruction_date
kc:/architecture/structure:diameter	/base/schemastaging/structure_extra/length
kc:/architecture/structure:height	/architecture/structure/height_meters
kc:/architecture/structure:length	/base/schemastaging/structure_extra/length
kc:/architecture/structure:official name	/base/schemastaging/context_name/official_name
kc:/architecture/structure:opened	/architecture/structure/opened
kc:/architecture/structure:width	/base/schemastaging/structure_extra/width
kc:/architecture/structure:width	/transportation/bridge/width
kc:/architecture/venue:capacity	/architecture/venue/capacity
kc:/collection/area_codes:major cities	/location/location/contains
kc:/collection/area_codes:major cities	/location/location/contains_major_portion_of
kc:/collection/area_codes:major cities	/location/location/containedby
kc:/collection/area_codes:state	/location/location/containedby
kc:/collection/area_codes:toll free	/base/schemastaging/area_code/toll_free
kc:/astronomy/asteroid:asteroid family	/astronomy/asteroid/member_of_asteroid_family
kc:/astronomy/asteroid:asteroid group	/astronomy/asteroid/member_of_asteroid_group
kc:/astronomy/asteroid:mass	/base/schemastaging/star_system_body_extra/mass
kc:/astronomy/asteroid:spectral type	/astronomy/asteroid/spectral_type
kc:/astronomy/astronomer:discovered	/astronomy/astronomer/astronomical_objects_discovered
kc:/astronomy/astronomical_discovery:discovered	/astronomy/astronomical_discovery/discovery_date
kc:/astronomy/astronomical_discovery:discoverer	/astronomy/astronomical_discovery/discoverer
kc:/astronomy/astronomical_discovery:discovery site	/astronomy/astronomical_discovery/discovery_site
kc:/astronomy/celestial_object:absolute magnitude	/astronomy/celestial_object/absolute_magnitude
kc:/astronomy/celestial_object:area	/base/schemastaging/celestial_object_extra/surface_area
kc:/astronomy/celestial_object:average temperature	/base/schemastaging/star_system_body_extra/average_surface_temperature
kc:/astronomy/celestial_object:circumference	/base/schemastaging/celestial_object_extra/equatorial_circumference
kc:/astronomy/celestial_object:color index	/astronomy/celestial_object/color_index
kc:/astronomy/celestial_object:declination	/astronomy/celestial_object/decllnation
kc:/astronomy/celestial_object:density	/base/schemastaging/celestial_object_extra/mean_density
kc:/astronomy/celestial_object:distance to earth	/astronomy/celestial_object/cosmological_distance
kc:/astronomy/celestial_object:escape velocity	/base/schemastaging/celestial_object_extra/escape_velocity
kc:/astronomy/celestial_object:gravity	/base/schemastaging/celestial_object_extra/gravity
kc:/astronomy/celestial_object:high temperature	/base/schemastaging/star_system_body_extra/temperature_range_high
kc:/astronomy/celestial_object:low temperature	/base/schemastaging/star_system_body_extra/temperature_range_low
kc:/astronomy/celestial_object:magnitude	/astronomy/celestial_object/magnitude
kc:/astronomy/celestial_object:right ascension	/astronomy/celestial_object/right_ascention
kc:/astronomy/comet:comet group	/astronomy/comet/comet_group
kc:/astronomy/comet:last perihelion	/astronomy/comet/last_perihelion
kc:/astronomy/comet:meteor shower spawned	/astronomy/comet/meteor_shower_spawned
kc:/astronomy/comet:predicted next perihelion	/astronomy/comet/next_perihelion_predicted
kc:/astronomy/constellation:name	/base/schemastaging/context_name/nickname
kc:/astronomy/constellation:stars	/astronomy/constellation/contains
kc:/astronomy/galaxy:apparent dimension	/astronomy/galaxy/diameter
kc:/astronomy/galaxy:apparent mass	/astronomy/galaxy/apparent_mass
kc:/astronomy/galaxy:constellation	/astronomy/galaxy/constellation
kc:/astronomy/galaxy:stars	/astronomy/galaxy/number_of_stars
kc:/astronomy/orbital_relationship:moon	/astronomy/orbital_relationship/orbited_by
kc:/astronomy/orbital_relationship:moon	/astronomy/orbital_relationship/orbited_by
kc:/astronomy/orbital_relationship:orbital period	/astronomy/orbital_relationship/orbital_period
kc:/astronomy/orbital_relationship:orbits	/astronomy/orbital_relationship/orbits
kc:/astronomy/planet:area	/base/schemastaging/celestial_object_extra/surface_area
kc:/astronomy/planet:diameter	/base/schemastaging/celestial_object_extra/mean_radius
kc:/astronomy/planet:distance from sun	/astronomy/orbital_relationship/semi_major_axis
kc:/astronomy/planet:length of day	/base/schemastaging/star_system_body_extra/solar_day
kc:/astronomy/planet:mass	/base/schemastaging/star_system_body_extra/mass
kc:/astronomy/planet:mean_radius	/base/schemastaging/celestial_object_extra/mean_radius
kc:/astronomy/star:constellation	/astronomy/star/constellation
kc:/astronomy/star:diameter	/astronomy/star/radius
kc:/astronomy/star:luminosity	/astronomy/star/luminosity
kc:/astronomy/star:mass	/astronomy/star/mass_m
kc:/astronomy/star:metallicity	/astronomy/star/metallicity
kc:/astronomy/star:radius	/astronomy/star/radius
kc:/astronomy/star:rotation speed	/astronomy/star/rotation
kc:/astronomy/star:spectral type	/astronomy/star/spectral_type
kc:/astronomy/star:star system	/astronomy/star/star_system
kc:/astronomy/star:surface temperature	/astronomy/star/temperature_k
kc:/astronomy/star_system_body:absolute magnitude	/astronomy/star_system_body/absolute_magnitude
kc:/automotive/model:make	/automotive/model/make
kc:/automotive/model:predecessor	/automotive/model/predecessor
kc:/automotive/model:successor	/automotive/model/successor
kc:/aviation/aircraft_designer:designed	/aviation/aircraft_designer/aircraft_models_designed
kc:/aviation/aircraft_model:accident	/aviation/aircraft_model/accidents
kc:/aviation/aircraft_model:cargo capacity	/aviation/aircraft_model/cargo_capacity
kc:/aviation/aircraft_model:cruise speed	/aviation/aircraft_model/cruise_speed
kc:/aviation/aircraft_model:designer	/aviation/aircraft_model/designed_by
kc:/aviation/aircraft_model:engine type	/aviation/aircraft_model/engine_type
kc:/aviation/aircraft_model:first flight	/aviation/aircraft_model/maiden_flight
kc:/aviation/aircraft_model:fuel capacity	/base/schemastaging/aircraft_model_extra/maximum_fuel_capacity
kc:/aviation/aircraft_model:introduced	/aviation/aircraft_model/introduced
kc:/aviation/aircraft_model:last flight	/aviation/aircraft_model/retired
kc:/aviation/aircraft_model:length	/aviation/aircraft_model/length_meters
kc:/aviation/aircraft_model:manufacturer	/aviation/aircraft_model/manufacturer
kc:/aviation/aircraft_model:range	/aviation/aircraft_model/range
kc:/aviation/aircraft_model:retired	/aviation/aircraft_model/retired
kc:/aviation/aircraft_model:top speed	/aviation/aircraft_model/maximum_speed_km_h
kc:/aviation/aircraft_model:unit cost	/aviation/aircraft_model/unit_cost
kc:/aviation/aircraft_model:weight	/base/schemastaging/aircraft_model_extra/manufacturers_empty_weight
kc:/aviation/aircraft_model:wingspan	/aviation/aircraft_model/wingspan
kc:/aviation/airport:code	/type/object/key
kc:/base/petbreeds/dog_breed:color	/base/petbreeds/dog_breed/color
kc:/base/petbreeds/dog_breed:height	/base/petbreeds/dog_breed/size
kc:/base/petbreeds/dog_breed:hypoallergenic	/base/petbreeds/dog_breed/hypoallergenic
kc:/base/petbreeds/dog_breed:life span	/base/petbreeds/dog_breed/life_expectancy
kc:/base/petbreeds/dog_breed:nickname	/base/schemastaging/context_name/nickname
kc:/base/petbreeds/dog_breed:shedding	/base/petbreeds/dog_breed/light_shedder
kc:/base/petbreeds/dog_breed:temperament	/base/petbreeds/dog_breed/temperament
kc:/base/petbreeds/dog_breed:weight	/base/petbreeds/dog_breed/size
kc:/base/schemastaging/sumo_wrestler:divisions	/base/schemastaging/sumo_wrestler/divisions
kc:/base/schemastaging/sumo_wrestler:heya	/base/schemastaging/sumo_wrestler/heya
kc:/base/schemastaging/sumo_wrestler:ranks	/base/schemastaging/sumo_wrestler/ranks
kc:/baseball/baseball_coach:team	/baseball/baseball_coach/current_team_coaching
kc:/baseball/baseball_coach:teams coached	/baseball/baseball_coach/historical_teams_coached
kc:/baseball/baseball_manager:team	/baseball/baseball_manager/current_team_managed
kc:/baseball/baseball_manager:teams managed	/baseball/baseball_manager/former_teams_managed
kc:/baseball/baseball_team:division	/baseball/baseball_team/division
kc:/baseball/baseball_team:league	/baseball/baseball_team/league
kc:/baseball/baseball_team:manager	/baseball/baseball_team/current_manager
kc:/baseball/baseball_team:stadium	/sports/sports_team/arena_stadium
kc:/basketball/basketball_coach:team	/basketball/basketball_coach/team
kc:/basketball/basketball_team:arena	/sports/sports_team/arena_stadium
kc:/basketball/basketball_team:conference	/basketball/basketball_team/conference
kc:/basketball/basketball_team:division	/basketball/basketball_team/division
kc:/basketball/basketball_team:head coach	/basketball/basketball_team/head_coach
kc:/basketball/basketball_team:theme song	/sports/sports_team/fight_song
kc:/biology/animal_breed:origin	/biology/animal_breed/place_of_origin
kc:/biology/deceased_organism:date of death	/biology/deceased_organism/date_of_death
kc:/biology/deceased_organism:place of death	/biology/deceased_organism/place_of_death
kc:/biology/domesticated_animal:breeds	/biology/domesticated_animal/breeds
kc:/biology/informal_biological_grouping:representative species	/biology/informal_biological_grouping/included_classifications
kc:/biology/organism:children	/biology/organism/children
kc:/biology/organism:date of birth	/biology/organism/date_of_birth
kc:/biology/organism:height	/biology/organism/height_meters
kc:/biology/organism:parents	/biology/organism/parents
kc:/biology/organism:place of birth	/biology/organism/place_of_birth
kc:/biology/organism:weight	/biology/organism/weight_kg
kc:/biology/organism_classification:earliest fossil record	/biology/organism_classification/earliest_fossil_record
kc:/biology/organism_classification:found in	/base/schemastaging/fish/found_in
kc:/biology/organism_classification:higher classification	/biology/organism_classification/higher_classification
kc:/biology/organism_classification:latest fossil record	/biology/organism_classification/latest_fossil_record
kc:/biology/organism_classification:lower classifications	/biology/organism_classification/lower_classifications
kc:/biology/organism_classification:rank	/biology/organism_classification/rank
kc:/biology/organism_classification:scientific name	/biology/organism_classification/scientific_name
kc:/biology/pedigreed_animal:breed	/biology/pedigreed_animal/breed
kc:/boats/ship:beam	/boats/ship/beam
kc:/boats/ship:construction started	/boats/ship/keel_laid
kc:/boats/ship:designer	/boats/ship/designer
kc:/boats/ship:displacement	/boats/ship/displacement
kc:/boats/ship:draught	/boats/ship/draught
kc:/boats/ship:hull material	/boats/ship/hull_material
kc:/boats/ship:keel laid	/boats/ship/keel_laid
kc:/boats/ship:launched	/boats/ship/launched
kc:/boats/ship:length	/boats/ship/length_overall
kc:/boats/ship:place built	/boats/ship/place_built
kc:/boats/ship:propulsion	/boats/ship/means_of_propulsion
kc:/boats/ship:ship builder	/boats/ship/ship_builder
kc:/boats/ship:weight	/boats/ship/displacement
kc:/book/author:book series	/book/author/series_written_or_contributed_to
kc:/book/author:books only	/book/author/works_written
kc:/book/author:books only	/book/illustrator/books_illustrated
kc:/book/author:school_or_movement	/book/author/school_or_movement
kc:/book/book:characters	/book/book/characters
kc:/book/book:editions	/book/book/editions
kc:/book/book:first edition	/book/book/first_edition
kc:/book/book:genre	/book/book/genre
kc:/book/book:illustrator	/book/book/interior_illustrations_by
kc:/book/book:language	/book/written_work/original_language
kc:/book/book:next in series	/book/written_work/next_in_series
kc:/book/book:previous in series	/book/written_work/previous_in_series
kc:/book/illustrator:books illustrated	/book/illustrator/books_illustrated
kc:/book/literary_series:author	/book/literary_series/author_s
kc:/book/literary_series:books	/book/literary_series/works_in_this_series
kc:/book/newspaper:circulation	/book/newspaper/circulation
kc:/book/written_work:author	/book/written_work/author
kc:/book/written_work:copyright date	/book/written_work/copyright_date
kc:/book/written_work:date written	/book/written_work/date_written
kc:/book/written_work:language_id	/book/written_work/original_language
kc:/book/written_work:published	/book/written_work/date_of_first_publication
kc:/business/business_location:address	/business/business_location/address
kc:/business/business_operation:assets	/business/business_operation/assets
kc:/business/business_operation:founder	/organization/organization/founders
kc:/business/business_operation:income	/business/business_operation/operating_income
kc:/business/business_operation:industry	/business/business_operation/industry
kc:/business/business_operation:nickname	/base/schemastaging/context_name/nickname
kc:/business/business_operation:official name	/base/schemastaging/context_name/official_name
kc:/business/business_operation:revenue	/business/business_operation/revenue
kc:/business/employer:employees	/business/employer/number_of_employees
kc:/chemistry/chemical_compound:boiling point	/chemistry/chemical_compound/boiling_point
kc:/chemistry/chemical_compound:cas id	/type/object/key
kc:/chemistry/chemical_compound:chemical structure	/chemistry/chemical_compound/structure_smiles
kc:/chemistry/chemical_compound:chemical structure	/chemistry/chemical_compound/structure_inchi
kc:/chemistry/chemical_compound:classification	/chemistry/chemical_compound/classifications
kc:/chemistry/chemical_compound:critical point pressure	/chemistry/chemical_compound/critical_point_pressure
kc:/chemistry/chemical_compound:critical point temperature	/chemistry/chemical_compound/critical_point_temperature
kc:/chemistry/chemical_compound:density	/chemistry/chemical_compound/density
kc:/chemistry/chemical_compound:formula	/chemistry/chemical_compound/formula
kc:/chemistry/chemical_compound:heat capacity	/chemistry/chemical_compound/heat_capacity_gas
kc:/chemistry/chemical_compound:heat capacity	/chemistry/chemical_compound/heat_capacity_liquid
kc:/chemistry/chemical_compound:heat capacity	/chemistry/chemical_compound/heat_capacity_solid
kc:/chemistry/chemical_compound:iupac id	/chemistry/chemical_compound/iuapc_id
kc:/chemistry/chemical_compound:melting point	/chemistry/chemical_compound/melting_point
kc:/chemistry/chemical_compound:molar entropy	/chemistry/chemical_compound/molar_entropy_gas
kc:/chemistry/chemical_compound:molar entropy	/chemistry/chemical_compound/molar_entropy_liquid
kc:/chemistry/chemical_compound:molar entropy	/chemistry/chemical_compound/molar_entropy_solid
kc:/chemistry/chemical_compound:molar mass	/chemistry/chemical_compound/average_molar_mass
kc:/chemistry/chemical_compound:triple point pressure	/chemistry/chemical_compound/triple_point_pressure
kc:/chemistry/chemical_compound:triple point temperature	/chemistry/chemical_compound/triple_point_temperature
kc:/chemistry/chemical_compound:vapor pressure	/chemistry/chemical_compound/vapor_pressure
kc:/chemistry/chemical_element:atomic mass	/chemistry/chemical_element/atomic_mass
kc:/chemistry/chemical_element:atomic number	/chemistry/chemical_element/atomic_number
kc:/chemistry/chemical_element:atomic radius	/chemistry/chemical_element/atomic_radius
kc:/chemistry/chemical_element:boiling point	/chemistry/chemical_element/boiling_point
kc:/chemistry/chemical_element:cas id	/type/object/key
kc:/chemistry/chemical_element:chemical series	/chemistry/chemical_element/chemical_series
kc:/chemistry/chemical_element:covalent radius	/chemistry/chemical_element/covalent_radius
kc:/chemistry/chemical_element:discovered	/chemistry/chemical_element/discovery_date
kc:/chemistry/chemical_element:discoverer	/chemistry/chemical_element/discoverer
kc:/chemistry/chemical_element:discovering country	/chemistry/chemical_element/discovering_country
kc:/chemistry/chemical_element:electron configuration	/chemistry/chemical_element/electron_configuration
kc:/chemistry/chemical_element:electronegativity	/chemistry/chemical_element/electronegativity
kc:/chemistry/chemical_element:electrons per shell	/chemistry/chemical_element/electrons_per_shell
kc:/chemistry/chemical_element:ionization energy	/chemistry/chemical_element/ionization_energy
kc:/chemistry/chemical_element:isotopes	/chemistry/chemical_element/isotopes
kc:/chemistry/chemical_element:melting point	/chemistry/chemical_element/melting_point
kc:/chemistry/chemical_element:symbol	/chemistry/chemical_element/symbol
kc:/chemistry/chemical_element:van der waals radius	/chemistry/chemical_element/van_der_waals_radius
kc:/chemistry/element_discoverer:discovered	/chemistry/element_discoverer/discovered
kc:/collection/knowledge_panels/has_phone:all kg phones	/education/educational_institution/phone_number
kc:/collection/knowledge_panels/has_phone:all kg phones	/business/business_location/phone_number
kc:/collection/knowledge_panels/has_phone:all kg phones	/organization/organization/phone_number
kc:/collection/airlines:flight_tracker	/aviation/airline/iata_airline_designator
kc:/common/topic:english name	/type/object/name
kc:/common/topic:official website	/common/topic/official_website
kc:/common/topic:related sites	/common/topic/social_media_presence
kc:/common/topic:related sites	/common/topic/topical_webpage
kc:/computer/computer:introduced	/computer/computer/introduced
kc:/computer/software:developer	/computer/software/developer
kc:/cricket/cricket_bowler:bowling style	/cricket/cricket_bowler/technique
kc:/cricket/cricket_coach:team	/cricket/cricket_coach/current_team
kc:/cricket/cricket_coach:teams coached	/cricket/cricket_coach/teams
kc:/cricket/cricket_player:all rounder	/cricket/cricket_player/all_rounder
kc:/cricket/cricket_player:batting style	/cricket/cricket_player/batting_style
kc:/cricket/cricket_player:bowling speed	/cricket/cricket_bowler/pace
kc:/cricket/cricket_player:odi stumps	/cricket/cricket_player/odi_stumps
kc:/cricket/cricket_player:test stumps	/cricket/cricket_player/test_stumps
kc:/cricket/cricket_team:coach	/cricket/cricket_team/coach
kc:/cricket/cricket_team:ground	/sports/sports_team/arena_stadium
kc:/cricket/cricket_team:owner	/sports/professional_sports_team/owner_s
kc:/cvg/computer_videogame:cvg_genre	/cvg/computer_videogame/cvg_genre
kc:/cvg/computer_videogame:designer	/cvg/computer_videogame/designers
kc:/cvg/computer_videogame:developer	/cvg/computer_videogame/developer
kc:/cvg/computer_videogame:publisher	/cvg/computer_videogame/publisher
kc:/cvg/computer_videogame:release date	/cvg/computer_videogame/release_date
kc:/cvg/computer_videogame:sequel	/cvg/computer_videogame/sequel
kc:/cvg/computer_videogame:versions	/cvg/computer_videogame/versions
kc:/cvg/game_version:developer	/cvg/game_version/developer
kc:/cvg/game_version:platform	/cvg/game_version/platform
kc:/education/educational_institution:campus	/education/educational_institution/campuses
kc:/education/educational_institution:color	/education/educational_institution/colors
kc:/education/educational_institution:enrollment	/education/educational_institution/total_enrollment
kc:/education/educational_institution:football team	/education/educational_institution/sports_teams
kc:/education/educational_institution:football team	/education/educational_institution/sports_teams
kc:/education/educational_institution:libraries	/base/schemastaging/educational_institution_extra/libraries
kc:/education/educational_institution:mascot	/education/educational_institution/mascot
kc:/education/educational_institution:motto	/education/educational_institution/motto
kc:/education/educational_institution:newspapers	/education/educational_institution/newspaper
kc:/education/educational_institution:nickname	/education/educational_institution/nickname
kc:/education/educational_institution:school type	/education/educational_institution/school_type
kc:/education/educational_institution:sports team	/education/educational_institution/sports_teams
kc:/education/school:district	/education/school/school_district
kc:/education/school:highest grade	/education/school/highest_grade_taught
kc:/education/school:lowest grade	/education/school/lowest_grade_taught
kc:/education/school:student teacher ratio	/education/school/student_teacher_ratio
kc:/education/school_mascot:school	/education/school_mascot/school
kc:/education/university:acceptance rate	/education/university/acceptance_rate
kc:/education/university:former name	/base/schemastaging/context_name/former_name
kc:/education/university:total staff	/education/educational_institution/number_of_staff
kc:/education/university:tuition	/education/university/domestic_tuition
kc:/exhibitions/exhibition_venue:exhibitions	/exhibitions/exhibition_venue/exhibitions_at_this_venue
kc:/fictional_universe/fictional_character:creator	/fictional_universe/fictional_character/character_created_by
kc:/film/director:films directed	/film/director/film
kc:/film/film:art director	/film/film/film_art_direction_by
kc:/film/film:budget	/film/film/estimated_budget
kc:/film/film:casting director	/film/film/film_casting_director
kc:/film/film:cinematography	/film/film/cinematography
kc:/film/film:costume design	/film/film/costume_design_by
kc:/film/film:country	/film/film/country
kc:/film/film:director	/film/film/directed_by
kc:/film/film:editor	/film/film/edited_by
kc:/film/film:executive producer	/film/film/executive_produced_by
kc:/film/film:featured song	/film/film/featured_song
kc:/film/film:genre	/film/film/genre
kc:/film/film:kmrb rating	/film/film/rating
kc:/film/film:language	/film/film/language
kc:/film/film:language_id	/film/film/language
kc:/film/film:mpaa rating	/film/film/rating
kc:/film/film:music	/film/film/music
kc:/film/film:prequel	/film/film/prequel
kc:/film/film:producer	/film/film/produced_by
kc:/film/film:production company	/film/film/production_companies
kc:/film/film:production design	/film/film/film_production_design_by
kc:/film/film:release date	/film/film/initial_release_date
kc:/film/film:screenplay	/film/film/written_by
kc:/film/film:sequel	/film/film/sequel
kc:/film/film:set decoration	/film/film/film_set_decoration_by
kc:/film/film:soundtrack	/film/film/soundtrack
kc:/film/film:story	/film/film/story_by
kc:/film/film:subjects	/film/film/subjects
kc:/film/film_series:films	/film/film_series/films_in_series
kc:/film/film_subject:movies	/film/film_subject/films
kc:/film/music_contributor:film music credits	/film/music_contributor/film
kc:/film/producer:films produced	/film/producer/film
kc:/film/writer:films written	/film/writer/film
kc:/food/dish:cuisine	/food/dish/cuisine
kc:/food/dish:type of dish	/food/dish/type_of_dish1
kc:/geography/body_of_water:area	/geography/body_of_water/surface_area
kc:/geography/body_of_water:bridges	/geography/body_of_water/bridges
kc:/geography/body_of_water:depth	/geography/body_of_water/depth
kc:/geography/body_of_water:islands	/geography/body_of_water/islands
kc:/geography/body_of_water:mean depth	/geography/body_of_water/mean_depth
kc:/geography/island:island group	/geography/island/island_group
kc:/geography/island:location	/geography/island/body_of_water
kc:/geography/island:max length	/geography/island/max_length
kc:/geography/island:max width	/geography/island/max_width
kc:/geography/island_group:attractions	/travel/travel_destination/tourist_attractions
kc:/geography/island_group:islands	/geography/island_group/islands_in_group
kc:/geography/lake:catchment area	/geography/lake/catchment_area
kc:/geography/lake:cities	/geography/lake/cities
kc:/geography/lake:fish species	/base/schemastaging/body_of_water_extra/fish
kc:/geography/lake:inflow source	/geography/lake/inflow
kc:/geography/lake:length	/geography/lake/length
kc:/geography/lake:outflow location	/geography/lake/outflow
kc:/geography/lake:shore length	/geography/lake/shore_length
kc:/geography/lake:surface elevation	/geography/lake/surface_elevation
kc:/geography/lake:volume	/geography/body_of_water/volume
kc:/geography/lake:width	/geography/lake/width
kc:/geography/mountain:elevation	/geography/mountain/elevation
kc:/geography/mountain:first ascender	/geography/mountain/first_ascenders
kc:/geography/mountain:first ascent	/geography/mountain/date_of_first_ascent
kc:/geography/mountain:last eruption	/geography/mountain/last_eruption
kc:/geography/mountain:mountain range	/geography/mountain/mountain_range
kc:/geography/mountain:prominence	/geography/mountain/prominence
kc:/geography/mountain_pass:elevation	/geography/mountain_pass/elevation
kc:/geography/mountain_pass:range	/geography/mountain_pass/range
kc:/geography/mountain_pass:road	/geography/mountain_pass/transversed_by
kc:/geography/mountain_range:countries	/location/location/containedby
kc:/geography/mountain_range:countries	/location/location/partially_containedby
kc:/geography/mountain_range:highest point	/geography/mountain_range/mountains
kc:/geography/mountain_range:mountains	/geography/mountain_range/mountains
kc:/geography/mountain_range:passes	/geography/mountain_range/passes
kc:/geography/mountaineer:first ascents	/geography/mountaineer/first_ascents
kc:/geography/river:basin area	/geography/river/basin_area
kc:/geography/river:cities	/geography/river/cities
kc:/geography/river:countries	/location/location/containedby
kc:/geography/river:countries	/location/location/partially_containedby
kc:/geography/river:discharge	/geography/river/discharge
kc:/geography/river:length	/geography/river/length
kc:/geography/river:mouth	/geography/river/mouth
kc:/geography/river:source	/geography/river/origin
kc:/geography/waterfall:flow rate	/geography/waterfall/flow_rate
kc:/geography/waterfall:height	/geography/waterfall/height
kc:/geography/waterfall:longest drop	/geography/waterfall/longest_height
kc:/geography/waterfall:number of drops	/geography/waterfall/drop_number
kc:/gf/event/event:category	/gf/event/event/category
kc:/gf/event/event:start datetime	/time/event/start_date
kc:/gf/event/event:start date	/time/event/start_date
kc:/gf/event/event:start day in month	/time/event/start_date
kc:/gf/event/event:start month	/time/event/start_date
kc:/gf/event/event:start time	/time/event/start_date
kc:/gf/event/event:venue	/time/event/locations
kc:/gf/event/event:related entities	/time/event/related_entities
kc:/gf/event/event:urls	/common/topic/topical_webpage
kc:/government/politician:current position	/government/politician/government_positions_held
kc:/government/politician:election campaigns	/government/politician/election_campaigns
kc:/government/politician:presidential_term	/government/politician/government_positions_held
kc:/government/politician:presidential_term_in_certain_socialist_country	/government/politician/government_positions_held
kc:/government/politician:previous position	/government/politician/government_positions_held
kc:/government/u_s_congressperson:previous roles	/government/politician/government_positions_held
kc:/government/us_president:president number	/government/us_president/presidency_number
kc:/government/us_president:vice president	/government/us_president/vice_president
kc:/government/us_vice_president:president	/government/us_vice_president/to_president
kc:/government/us_vice_president:vice president number	/government/us_vice_president/vice_president_number
kc:/ice_hockey/hocket_team:arena	/sports/sports_team/arena_stadium
kc:/ice_hockey/hockey_coach:team	/ice_hockey/hockey_coach/current_team
kc:/ice_hockey/hockey_player:shoots	/ice_hockey/hockey_player/shoots
kc:/ice_hockey/hockey_team:captain	/ice_hockey/hockey_team/captain
kc:/ice_hockey/hockey_team:coach	/ice_hockey/hockey_team/coach
kc:/ice_hockey/hockey_team:conference	/ice_hockey/hockey_team/conference
kc:/ice_hockey/hockey_team:division	/ice_hockey/hockey_team/division
kc:/law/invention:inventor	/law/invention/inventor
kc:/law/inventor:inventions	/law/inventor/inventions
kc:/location/administrative_division:capital	/location/administrative_division/capital
kc:/location/administrative_division:colleges	/location/location/contains
kc:/location/administrative_division:universities	/location/location/contains
kc:/location/citytown:attractions	/travel/travel_destination/tourist_attractions
kc:/location/citytown:attractions	/location/location/contains
kc:/location/citytown:postal code	/location/citytown/postal_codes
kc:/location/citytown:zip code	/location/citytown/postal_codes
kc:/location/continent:countries	/location/location/contains
kc:/location/continent:countries	/location/location/contains_major_portion_of
kc:/location/country:attractions	/travel/travel_destination/tourist_attractions
kc:/location/country:attractions	/location/location/contains
kc:/location/country:capital	/location/country/capital
kc:/location/country:continent	/location/location/containedby
kc:/location/country:continent	/location/location/primarily_containedby
kc:/location/country:currency	/location/country/currency_used
kc:/location/country:dialing code	/location/country/calling_code
kc:/location/statistical_region:fertility_rate	/location/statistical_region/fertility_rate
kc:/location/statistical_region:fertility_rate_world_bank	/location/statistical_region/fertility_rate
kc:/location/statistical_region:gdp_nominal	/location/statistical_region/gdp_nominal
kc:/location/statistical_region:gdp_nominal_world_bank	/location/statistical_region/gdp_nominal
kc:/location/statistical_region:gdp_nominal_per_capita	/location/statistical_region/gdp_nominal_per_capita
kc:/location/statistical_region:gdp_nominal_per_capita_world_bank	/location/statistical_region/gdp_nominal_per_capita
kc:/location/country:government	/location/country/form_of_government
kc:/location/country:iso code	/type/object/key
kc:/location/country:language	/location/country/official_language
kc:/location/statistical_region:life_expectancy	/location/statistical_region/life_expectancy
kc:/location/statistical_region:life_expectancy_world_bank	/location/statistical_region/life_expectancy
kc:/location/country:provinces	/location/country/administrative_divisions
kc:/location/country:provinces	/location/country/administrative_divisions
kc:/location/country:provinces	/location/country/administrative_divisions
kc:/location/country:provinces	/location/country/administrative_divisions
kc:/location/country:provinces	/location/country/administrative_divisions
kc:/location/country:provinces	/location/country/administrative_divisions
kc:/location/country:provinces	/location/country/administrative_divisions
kc:/location/dated_location:founded	/location/dated_location/date_founded
kc:/location/location:address	/location/location/street_address
kc:/location/location:airport	/location/location/contains
kc:/location/location:airport	/location/location/nearby_airports
kc:/location/location:area	/location/location/area
kc:/location/location:city	/location/location/containedby
kc:/location/location:colleges	/location/location/contains
kc:/location/location:contained by	/location/location/containedby
kc:/location/location:continent	/location/location/containedby
kc:/location/location:continent	/location/location/primarily_containedby
kc:/location/location:coordinates	/location/location/geolocation
kc:/location/location:country	/location/administrative_division/country
kc:/location/location:country	/location/location/containedby
kc:/location/location:county	/location/location/containedby
kc:/location/location:museums	/travel/travel_destination/tourist_attractions
kc:/location/location:prefecture	/location/location/containedby
kc:/location/location:province	/location/location/containedby
kc:/location/location:state	/location/location/containedby
kc:/location/location:time zone	/location/location/time_zones
kc:/location/statistical_region:minimum_wage	/location/statistical_region/minimum_wage
kc:/location/statistical_region:minimum_wage_eurostat	/location/statistical_region/minimum_wage
kc:/location/statistical_region:population	/location/statistical_region/population
kc:/location/statistical_region:population_world_bank	/location/statistical_region/population
kc:/location/statistical_region:population_instituto_nacional_de_estadistica	/location/statistical_region/population
kc:/location/statistical_region:population_istituto_nazionale_di_statistica	/location/statistical_region/population
kc:/location/statistical_region:population_instituto_nacional_de_estadistica_y_geografia	/location/statistical_region/population
kc:/location/statistical_region:population_us_census	/location/statistical_region/population
kc:/location/statistical_region:unemployment_rate	/location/statistical_region/unemployment_rate
kc:/location/statistical_region:unemployment_rate_eurostat	/location/statistical_region/unemployment_rate
kc:/location/statistical_region:unemployment_rate_us_bls	/location/statistical_region/unemployment_rate
kc:/location/statistical_region:population_growth_rate	/location/statistical_region/population_growth_rate
kc:/location/statistical_region:population_growth_rate_world_bank	/location/statistical_region/population_growth_rate
kc:/location/statistical_region:gdp_growth_rate	/location/statistical_region/gdp_growth_rate
kc:/location/statistical_region:gdp_growth_rate_world_bank	/location/statistical_region/gdp_growth_rate
kc:/location/statistical_region:co2_emissions_per_capita	/location/statistical_region/co2_emissions_per_capita
kc:/location/statistical_region:co2_emissions_per_capita_world_bank	/location/statistical_region/co2_emissions_per_capita
kc:/location/statistical_region:energy_use_per_capita	/location/statistical_region/energy_use_per_capita
kc:/location/statistical_region:energy_use_per_capita_world_bank	/location/statistical_region/energy_use_per_capita
kc:/location/statistical_region:electricity_consumption_per_capita	/location/statistical_region/electricity_consumption_per_capita
kc:/location/statistical_region:electricity_consumption_per_capita_world_bank	/location/statistical_region/electricity_consumption_per_capita
kc:/location/statistical_region:internet_users_percent_population	/location/statistical_region/internet_users_percent_population
kc:/location/statistical_region:internet_users_percent_population_world_bank	/location/statistical_region/internet_users_percent_population
kc:/location/statistical_region:gni_per_capita_in_ppp_dollars	/location/statistical_region/gni_per_capita_in_ppp_dollars
kc:/location/statistical_region:gni_per_capita_in_ppp_dollars_world_bank	/location/statistical_region/gni_per_capita_in_ppp_dollars
kc:/location/statistical_region:gni_in_ppp_dollars	/location/statistical_region/gni_in_ppp_dollars
kc:/location/statistical_region:gni_in_ppp_dollars_world_bank	/location/statistical_region/gni_in_ppp_dollars
kc:/location/statistical_region:government_debt_percent_gdp	/location/statistical_region/government_debt_percent_gdp
kc:/location/statistical_region:government_debt_percent_gdp_eurostat	/location/statistical_region/government_debt_percent_gdp
kc:/location/statistical_region:broadband_penetration_rate	/location/statistical_region/broadband_penetration_rate
kc:/location/statistical_region:broadband_penetration_rate_eurostat	/location/statistical_region/broadband_penetration_rate
kc:/location/us_county:cities	/location/location/contains
kc:/location/us_county:rivers	/location/location/contains
kc:/location/us_county:rivers	/location/location/partially_contains
kc:/location/us_state:abbreviation	/base/schemastaging/context_name/abbreviation
kc:/location/us_state:attractions	/travel/travel_destination/tourist_attractions
kc:/location/us_state:attractions	/location/location/contains
kc:/location/us_state:cities	/location/location/contains
kc:/location/us_state:minimum wage	/location/statistical_region/minimum_wage
kc:/location/us_state:nickname	/base/schemastaging/context_name/nickname
kc:/location/us_state:rivers	/location/location/contains
kc:/location/us_state:rivers	/location/location/partially_contains
kc:/location/us_state:statehood	/location/dated_location/date_founded
kc:/martial_arts/martial_artist:certifications	/martial_arts/martial_artist/certifications
kc:/martial_arts/martial_artist:instructor	/martial_arts/martial_artist/instructor
kc:/martial_arts/martial_artist:martial art	/martial_arts/martial_artist/martial_art
kc:/martial_arts/martial_artist:students	/martial_arts/martial_artist/martial_arts_students
kc:/media_common/adaptation:adapted from	/media_common/adaptation/adapted_from
kc:/media_common/adapted_work:adaptations	/media_common/adapted_work/adaptations
kc:/media_common/adapted_work:adaptations	/media_common/adapted_work/adaptations
kc:/media_common/adapted_work:adaptations	/media_common/adapted_work/adaptations
kc:/medicine/condition_prevention_factors:may prevent	/medicine/condition_prevention_factors/conditions_this_may_prevent
kc:/medicine/disease:causes	/medicine/disease/causes
kc:/medicine/disease:causes	/medicine/disease_cause/diseases
kc:/medicine/disease:drug treatments	/medicine/disease/treatments
kc:/medicine/disease:includes	/medicine/disease/includes_diseases
kc:/medicine/disease:nondrug treatments	/medicine/disease/treatments
kc:/medicine/disease:parents	/medicine/disease/parent_disease
kc:/medicine/disease:risk factors	/medicine/disease/risk_factors
kc:/medicine/disease:risk factors	/medicine/risk_factor/diseases
kc:/medicine/disease:symptoms	/medicine/disease/symptoms
kc:/medicine/drug:class	/medicine/drug/drug_class
kc:/medicine/drug:compound of	/medicine/drug/active_moieties
kc:/medicine/drug:contraindications	/medicine/medical_treatment/contraindications
kc:/medicine/drug:controlled substance	/medicine/drug/legal_status
kc:/medicine/drug:may prevent	/medicine/condition_prevention_factors/conditions_this_may_prevent
kc:/medicine/drug:may treat	/medicine/medical_treatment/used_to_treat
kc:/medicine/drug:pregnancy	/medicine/drug/pregnancy_category
kc:/medicine/drug:side effects	/medicine/medical_treatment/side_effects
kc:/medicine/drug_class:drugs in class	/medicine/drug_class/drugs
kc:/medicine/drug_pregnancy_category:country	/medicine/drug_pregnancy_category/country
kc:/medicine/drug_pregnancy_category:regulating authority	/medicine/drug_pregnancy_category/regulating_authority
kc:/medicine/drug_pregnancy_category:summary	/base/schemastaging/drug_pregnancy_category_extra/pregnancy_risk_summary
kc:/medicine/medical_treatment:contraindications	/medicine/medical_treatment/contraindications
kc:/medicine/medical_treatment:may treat	/medicine/medical_treatment/used_to_treat
kc:/medicine/medical_treatment:side effects	/medicine/medical_treatment/side_effects
kc:/medicine/symptom:side effects	/medicine/symptom/side_effect_of
kc:/medicine/symptom:symptom of	/medicine/symptom/symptom_of
kc:/meteorology/tropical_cyclone:affected area	/meteorology/tropical_cyclone/affected_areas
kc:/meteorology/tropical_cyclone:category	/meteorology/tropical_cyclone/category
kc:/meteorology/tropical_cyclone:direct fatalities	/meteorology/tropical_cyclone/direct_fatalities
kc:/meteorology/tropical_cyclone:dissipated	/meteorology/tropical_cyclone/dissipated
kc:/meteorology/tropical_cyclone:formed	/meteorology/tropical_cyclone/formed
kc:/meteorology/tropical_cyclone:highest winds	/meteorology/tropical_cyclone/highest_winds
kc:/meteorology/tropical_cyclone:indirect fatalities	/meteorology/tropical_cyclone/indirect_fatalities
kc:/meteorology/tropical_cyclone:lowest pressure	/meteorology/tropical_cyclone/lowest_pressure
kc:/meteorology/tropical_cyclone:total fatalities	/meteorology/tropical_cyclone/total_fatalities
kc:/music/album:artist	/music/album/artist
kc:/music/album:genre	/music/album/genre
kc:/music/album:release date	/music/album/release_date
kc:/music/album:release type	/music/album/release_type
kc:/music/artist:active from	/music/artist/active_start
kc:/music/artist:active until	/music/artist/active_end
kc:/music/artist:albums	/music/artist/album
kc:/music/artist:first album	/music/artist/album
kc:/music/artist:genre	/music/artist/genre
kc:/music/artist:latest album	/music/artist/album
kc:/music/artist:origin	/music/artist/origin
kc:/music/artist:record label	/music/artist/label
kc:/music/artist:songs	/music/artist/track
kc:/music/artist:supporting artist	/music/artist/supporting_artists
kc:/music/composer:compositions	/music/composer/compositions
kc:/music/composition:completed	/music/composition/date_completed
kc:/music/composition:composer	/music/composition/composer
kc:/music/composition:date of first performance	/music/composition/date_of_first_performance
kc:/music/composition:form	/music/composition/form
kc:/music/composition:key	/music/composition/musical_key
kc:/music/composition:language	/music/composition/language
kc:/music/composition:lyricist	/music/composition/lyricist
kc:/music/composition:place composed	/music/composition/place_composed
kc:/music/composition:place of first performance	/music/composition/place_of_first_performance
kc:/music/composition:tracks	/music/composition/recordings
kc:/music/group_member:songs	/music/artist/track
kc:/music/producer:albums	/music/producer/releases_produced
kc:/music/producer:songs	/music/producer/tracks_produced
kc:/music/recording:artist	/music/recording/artist
kc:/music/recording:length	/music/recording/length
kc:/music/release_track:length	/music/release_track/length
kc:/opera/librettist:libretti	/opera/librettist/libretti
kc:/opera/opera:arias	/music/composition/includes
kc:/opera/opera:first performance	/opera/opera/date_of_first_performance
kc:/opera/opera:language	/opera/opera/language
kc:/opera/opera:librettist	/opera/opera/librettist
kc:/opera/opera:premiere	/opera/opera/premiere_production
kc:/opera/opera:songs	/music/composition/includes
kc:/opera/opera:written	/opera/opera/date_written
kc:/organization/endowed_organization:endowment	/organization/endowed_organization/endowment
kc:/organization/non_profit_organization:ein	/type/object/key
kc:/organization/non_profit_organization:type	/base/schemastaging/non_profit_extra/classification
kc:/organization/organization:customer service phone	/base/schemastaging/organization_extra/phone_number
kc:/organization/organization:technical support phone	/base/schemastaging/organization_extra/phone_number
kc:/organization/organization:billing support phone	/base/schemastaging/organization_extra/phone_number
kc:/organization/organization:bill pay phone	/base/schemastaging/organization_extra/phone_number
kc:/organization/organization:customer service contact page	/base/schemastaging/organization_extra/contact_webpage
kc:/organization/organization:date founded	/organization/organization/date_founded
kc:/organization/organization:founder	/organization/organization/founders
kc:/organization/organization:headquarters	/organization/organization/headquarters
kc:/organization/organization:leadership	/organization/organization/leadership
kc:/organization/organization:place founded	/organization/organization/place_founded
kc:/organization/organization:slogan	/organization/organization/slogan
kc:/people/deceased_person:assassination	/people/deceased_person/date_of_death
kc:/people/deceased_person:assassination	/people/deceased_person/date_of_death
kc:/people/deceased_person:cause of death	/people/deceased_person/cause_of_death
kc:/people/deceased_person:date of birth	/people/person/date_of_birth
kc:/people/deceased_person:date of burial	/people/deceased_person/date_of_burial
kc:/people/deceased_person:date of cremation	/people/deceased_person/date_of_cremation
kc:/people/deceased_person:date of death	/people/deceased_person/date_of_death
kc:/people/deceased_person:last album	/music/artist/album
kc:/people/deceased_person:place of assassination	/people/deceased_person/place_of_death
kc:/people/deceased_person:place of assassination	/people/deceased_person/place_of_death
kc:/people/deceased_person:place of birth	/people/person/place_of_birth
kc:/people/deceased_person:place of burial	/people/deceased_person/place_of_burial
kc:/people/deceased_person:place of cremation	/people/deceased_person/place_of_cremation
kc:/people/deceased_person:place of death	/people/deceased_person/place_of_death
kc:/people/person:age	/people/person/date_of_birth
kc:/people/person:children	/people/person/children
kc:/people/person:current_partner	/people/person/spouse_s
kc:/people/person:date of birth	/people/person/date_of_birth
kc:/people/person:daughter	/people/person/children
kc:/people/person:education	/people/person/education
kc:/people/person:ethnicity	/people/person/ethnicity
kc:/people/person:father	/people/person/parents
kc:/people/person:full name	/base/schemastaging/context_name/official_name
kc:/people/person:gender	/people/person/gender
kc:/people/person:height	/people/person/height_meters
kc:/people/person:languages	/people/person/languages
kc:/people/person:mother	/people/person/parents
kc:/people/person:movies	/film/film_story_contributor/film_story_credits
kc:/people/person:movies	/film/director/film
kc:/people/person:movies	/film/producer/film
kc:/people/person:movies	/film/writer/film
kc:/people/person:movies	/film/cinematographer/film
kc:/people/person:nationality_id	/people/person/nationality
kc:/people/person:net worth	/base/schemastaging/person_extra/net_worth
kc:/people/person:nickname	/base/schemastaging/context_name/nickname
kc:/people/person:parents	/people/person/parents
kc:/people/person:place of birth	/people/person/place_of_birth
kc:/people/person:places lived	/people/person/places_lived
kc:/people/person:plays	/book/author/works_written
kc:/people/person:plays	/theater/theatrical_composer/plays_composed
kc:/people/person:profession	/people/person/profession
kc:/people/person:realtime-plus-posts	/type/object/key
kc:/people/person:religion	/people/person/religion
kc:/people/person:son	/people/person/children
kc:/people/person:spouse	/people/person/spouse_s
kc:/people/person:tv shows	/tv/tv_program_creator/programs_created
kc:/people/person:upcoming movie	/film/director/film
kc:/people/person:upcoming movie	/film/producer/film
kc:/people/person:weight	/people/person/weight_kg
kc:/people/place_of_interment:burials	/people/place_of_interment/interred_here
kc:/periodicals/newspaper_circulation_area:newspapers	/periodicals/newspaper_circulation_area/newspapers
kc:/projects/project:completed	/projects/project/actual_completion_date
kc:/projects/project:planned completion date	/projects/project/planned_completion_date
kc:/projects/project:project focus	/projects/project/project_focus
kc:/projects/project:start date	/projects/project/start_date
kc:/protected_sites/protected_site:management	/protected_sites/protected_site/governing_body
kc:/soccer/football_player:career apperances	/soccer/football_player/total_career_appearances
kc:/soccer/football_player:career goals	/soccer/football_player/total_career_goals
kc:/soccer/football_team:ground	/sports/sports_team/arena_stadium
kc:/spaceflight/astronaut:first space flight	/spaceflight/astronaut/missions
kc:/spaceflight/astronaut:space agency	/spaceflight/astronaut/space_agency
kc:/spaceflight/astronaut:space missions	/spaceflight/astronaut/missions
kc:/spaceflight/astronaut:space time	/spaceflight/astronaut/space_time_minutes
kc:/spaceflight/satellite:launch date	/spaceflight/satellite/launch_date
kc:/spaceflight/satellite:launch mass	/spaceflight/satellite/launch_mass_kg
kc:/spaceflight/satellite:launch site	/spaceflight/satellite/launch_site
kc:/spaceflight/satellite:orbit height	/spaceflight/satellite/altitude
kc:/spaceflight/satellite:power	/spaceflight/satellite/power_watts
kc:/spaceflight/satellite:primary use	/spaceflight/satellite/primary_use
kc:/spaceflight/satellite:speed	/spaceflight/satellite/speed_on_orbit
kc:/spaceflight/space_program:completed	/spaceflight/space_program/completed
kc:/spaceflight/space_program:missions	/spaceflight/space_program/missions
kc:/spaceflight/space_program:started	/spaceflight/space_program/started
kc:/spaceflight/spacecraft:launch date	/base/schemastaging/spacecraft_extra/first_launch
kc:/spaceflight/spacecraft:launch date	/spaceflight/satellite/launch_date
kc:/spaceflight/spacecraft:launch site	/spaceflight/space_mission/launch_site
kc:/spaceflight/spacecraft:manufacturer	/spaceflight/spacecraft/manufacturer
kc:/spaceflight/spacecraft:speed	/base/schemastaging/spacecraft_extra/maximum_speed
kc:/sports/boxer:division	/sports/boxer/weight_division
kc:/sports/boxer:reach	/sports/boxer/reach
kc:/sports/boxer:stance	/sports/boxer/stance
kc:/sports/cyclist:tour de france win	/award/competitor/competitions_won
kc:/sports/defunct_sports_team:years active	/sports/defunct_sports_team/active
kc:/sports/mascot:team	/sports/mascot/team
kc:/sports/pro_athlete:height	/people/person/height_meters
kc:/sports/pro_athlete:salary	/base/schemastaging/athlete_extra/salary
kc:/sports/pro_athlete:stats	/type/object/mid
kc:/sports/pro_athlete:team	/sports/pro_athlete/teams
kc:/sports/pro_athlete:former team	/sports/pro_athlete/teams
kc:/sports/pro_athlete:weight	/people/person/weight_kg
kc:/sports/professional_sports_team:owner	/sports/professional_sports_team/owner_s
kc:/sports/sports_facility:capacity	/architecture/venue/capacity
kc:/sports/sports_facility:team	/sports/sports_facility/teams
kc:/sports/sports_team:abbreviation	/sports/sports_team/abbreviation
kc:/sports/sports_team:arena/stadium	/sports/sports_team/arena_stadium
kc:/sports/sports_team:coaches	/sports/sports_team/coaches
kc:/sports/sports_team:color	/sports/sports_team/colors
kc:/sports/sports_team:fight song	/sports/sports_team/fight_song
kc:/sports/sports_team:former name	/base/schemastaging/context_name/former_name
kc:/sports/sports_team:founded	/sports/sports_team/founded
kc:/sports/sports_team:location	/sports/sports_team/location
kc:/sports/sports_team:manager	/base/schemastaging/sports_team_extra/managers
kc:/sports/sports_team:mascot	/sports/sports_team/team_mascot
kc:/sports/sports_team:nickname	/base/schemastaging/context_name/nickname
kc:/sports/sports_team:sport	/sports/sports_team/sport
kc:/sports/sports_team_coach:teams coached	/sports/sports_team_coach/teams_coached
kc:/symbols/namesake:named_after	/symbols/namesake/named_after
kc:/tennis/tennis_player:career earnings	/tennis/tennis_player/career_prize_money
kc:/tennis/tennis_player:grand slams	/base/schemastaging/tennis_player_extra/singles_grand_slams
kc:/tennis/tennis_player:handed	/tennis/tennis_player/handed
kc:/tennis/tennis_player:number of titles	/tennis/tennis_player/number_of_tennis_titles
kc:/tennis/tennis_player:tennis grip	/tennis/tennis_player/tennis_grip
kc:/tennis/tennis_player:turned pro	/tennis/tennis_player/year_turned_pro
kc:/theater/play:characters	/theater/play/characters
kc:/theater/play:composer	/theater/play/composer
kc:/theater/play:first performance	/theater/play/date_of_first_performance
kc:/theater/play:lyricist	/theater/play/lyricist
kc:/theater/play:orchestrator	/theater/play/orchestrator
kc:/theater/play:playwright	/book/written_work/author
kc:/theater/theater:theatrical productions staged	/theater/theater/theatrical_productions_staged_here
kc:/theater/theater:capacity	/architecture/venue/capacity
kc:/theater/theater_production:choreographer	/theater/theater_production/choreographer
kc:/theater/theater_production:date closed	/theater/theater_production/date_closed
kc:/theater/theater_production:date opened	/theater/theater_production/date_opened
kc:/theater/theater_production:director	/theater/theater_production/director
kc:/theater/theater_production:music director	/theater/theater_production/musical_director
kc:/theater/theater_production:performances	/theater/theater_production/number_of_performances
kc:/theater/theater_production:producer	/theater/theater_production/producer
kc:/theater/theater_production:producing company	/theater/theater_production/producing_company
kc:/theater/theater_production:venue	/theater/theater_production/performed_at
kc:/time/time_zone:offset from uct	/time/time_zone/offset_from_uct
kc:/transportation/bridge:body of water	/transportation/bridge/body_of_water_spanned
kc:/transportation/bridge:bridge type	/transportation/bridge/bridge_type
kc:/transportation/bridge:clearance below	/transportation/bridge/clearance_below
kc:/transportation/bridge:location	/transportation/bridge/locale
kc:/transportation/bridge:longest span	/transportation/bridge/longest_span
kc:/transportation/bridge:number of spans	/transportation/bridge/number_of_spans
kc:/transportation/bridge:total length	/transportation/bridge/total_length
kc:/transportation/bridge:width	/transportation/bridge/width
kc:/transportation/road:formed	/transportation/road/formed
kc:/transportation/road:highway system	/transportation/road/highway_system
kc:/transportation/road:length	/transportation/road/length
kc:/transportation/road:major city	/transportation/road/major_cities
kc:/travel/hotel/accommodation type	/travel/accommodation/accommodation_type
kc:/travel/hotel/number of guest beds	/travel/hotel/number_of_guest_beds
kc:/travel/tourist_attraction:disability access	/base/services/retail_location/disability_access
kc:/travel/tourist_attraction:near travel destination	/travel/tourist_attraction/near_travel_destination
kc:/travel/tourist_attraction:parking options	/base/services/retail_location/parking_options
kc:/travel/tourist_attraction:restroom access	/base/services/retail_location/restroom_access
kc:/tv/tv_actor:tv shows	/tv/tv_actor/starring_roles
kc:/tv/tv_program:episodes	/tv/tv_program/episodes
kc:/tv/tv_program:filming locations	/tv/tv_program/filming_locations
kc:/tv/tv_program:final episode	/tv/tv_program/air_date_of_final_episode
kc:/tv/tv_program:first episode	/tv/tv_program/air_date_of_first_episode
kc:/tv/tv_program:genre	/tv/tv_program/genre
kc:/tv/tv_program:language	/tv/tv_program/languages
kc:/tv/tv_program:number of episodes	/tv/tv_program/number_of_episodes
kc:/tv/tv_program:program creator	/tv/tv_program/program_creator
kc:/tv/tv_program:program creator organization	/tv/tv_program/program_creator
kc:/tv/tv_program:program creator person	/tv/tv_program/program_creator
kc:/tv/tv_program:running time	/tv/tv_program/episode_running_time
kc:/tv/tv_program:seasons	/tv/tv_program/number_of_seasons
kc:/tv/tv_program:soundtrack	/tv/tv_program/soundtrack
kc:/tv/tv_program:theme song	/tv/tv_program/theme_song
kc:/tv/tv_series_episode:air date	/tv/tv_series_episode/air_date
kc:/tv/tv_series_episode:season number	/tv/tv_series_episode/season_number
kc:/tv/tv_series_episode:episode number	/tv/tv_series_episode/episode_number
kc:/tv/tv_series_episode:writer	/tv/tv_series_episode/writer
kc:/tv/tv_series_episode:director	/tv/tv_series_episode/director
kc:/tv/tv_series_season:airdate from	/tv/tv_series_season/from
kc:/tv/tv_series_season:airdate to	/tv/tv_series_season/to
kc:/tv/tv_series_season:winner	/award/competition/winner
kc:/visual_art/artwork:artist	/visual_art/artwork/artist
kc:/visual_art/artwork:completed	/visual_art/artwork/date_completed
kc:/visual_art/artwork:dimensions	/visual_art/artwork/dimensions_meters
kc:/visual_art/artwork:form	/visual_art/artwork/art_form
kc:/visual_art/artwork:genre	/visual_art/artwork/art_genre
kc:/visual_art/artwork:location	/visual_art/artwork/locations
kc:/visual_art/artwork:media	/visual_art/artwork/media
kc:/visual_art/artwork:part of series	/visual_art/artwork/belongs_to_series
kc:/visual_art/artwork:period	/visual_art/artwork/period_or_movement
kc:/visual_art/artwork:started	/visual_art/artwork/date_begun
kc:/visual_art/artwork:subject	/visual_art/artwork/art_subject
kc:/visual_art/visual_artist:art series	/visual_art/visual_artist/art_series
kc:/visual_art/visual_artist:form	/visual_art/visual_artist/art_forms
kc:/visual_art/visual_artist:period	/visual_art/visual_artist/associated_periods_or_movements
kc:/visual_art/visual_artist:works	/visual_art/visual_artist/artworks
kc:/wine/wine:color	/wine/wine/color
kc:/wine/wine:country	/wine/wine/country
kc:/wine/wine:percentage alcohol	/wine/wine/percentage_alcohol
kc:/wine/wine:wine producer	/wine/wine/wine_producer
kc:/wine/wine:vintage	/wine/wine/vintage
kc:/wine/wine:wine type	/wine/wine/wine_type
kc:/zoos/zoo:area	/location/location/area
kc:/zoos/zoo:closed	/zoos/zoo/closed
kc:/zoos/zoo:exhibits	/zoos/zoo/exhibits
kc:/zoos/zoo:notable animal	/zoos/zoo/notable_animals
kc:/zoos/zoo:number of animals	/zoos/zoo/num_animals
kc:/zoos/zoo:number of species	/zoos/zoo/num_species
kc:/zoos/zoo:opened	/zoos/zoo/opened
meta:/architecture/skyscraper:tagline	/architecture/structure/height_meters
meta:/common/topic:kg books description	/common/topic/description
meta:/dataworld/information_source:attribution_info	/dataworld/information_source/provider
meta:/film/film:tagline	/film/film/initial_release_date
meta:/geography/mountain:tagline	/geography/mountain/elevation
meta:/geography/mountain_pass:tagline	/geography/mountain_pass/elevation
meta:/geography/waterfall:tagline	/geography/waterfall/height
meta:/medicine/drug:subtitles	/medicine/drug/legal_status
meta:/medicine/drug_brand:generic name	/medicine/drug_brand/canonical_drug
meta:/meteorology/tropical_cyclone:tagline	/meteorology/tropical_cyclone/formed
meta:/music/recording:canonical version	/music/recording/canonical_version
meta:/music/recording:composition	/music/recording/song
